###################
#                 #
#    X            #
#         X       #
#                 #
#         P       #
#    O        O   #
#                 #
###################